 ____________________  
|                    | 
|                $   | 
|     $              | 
|                    | 
|         @          | 
|                    | 
|   $                | 
|                $   | 
|    $               | 
|____________________| 